0,0,0,0,0,0,0,0,0,0,0,0,0,0,0,0
0,0,0,0,0,0,0,0,0,0,0,0,0,0,0,0
0,0,0,0,0,0,0,0,0,0,0,0,0,0,0,0
2,0,8,4,2,0,2,0,0,4,0,8,0,0,0,2
0,1,1,1,0,0,1,1,7,1,1,1,1,1,7,0
0,0,0,0,0,0,0,0,6,0,1,0,0,0,6,0
2,4,0,8,0,2,0,0,6,0,1,0,0,0,6,0
0,1,7,1,1,0,0,1,1,1,1,0,0,7,1,0
0,0,6,0,0,0,0,0,0,0,0,0,0,6,0,0
0,2,6,4,0,8,0,2,0,0,0,2,12,6,10,2
0,0,1,1,7,1,1,0,0,0,0,0,1,1,1,0
0,0,0,0,6,0,0,0,0,0,0,0,0,0,0,0
0,0,0,0,6,0,0,0,0,0,0,0,9,0,0,0
0,1,1,1,1,1,1,1,0,0,1,1,1,1,1,0
11,11,11,11,11,11,11,11,11,11,11,11,11,11,11,11
