0,0,0,0,0,0,0,0,0,0,0,0,0,0,0,0
0,0,0,0,0,0,0,0,0,0,0,0,0,0,0,0
0,0,0,0,0,0,0,0,0,0,0,0,0,0,0,0
2,0,12,0,2,0,2,0,0,5,0,8,0,0,0,2
0,1,1,1,0,13,0,1,7,1,1,1,1,1,7,0
0,0,0,0,0,0,0,0,6,0,0,0,0,0,6,0
2,0,0,8,0,0,0,0,6,0,0,2,0,0,6,2
0,1,7,1,1,1,1,1,1,0,0,0,1,7,1,0
0,0,6,0,0,0,0,0,0,0,0,0,0,6,0,0
0,2,6,0,0,8,0,2,0,2,0,0,8,6,0,2
0,0,1,1,7,1,1,0,0,0,1,7,1,1,1,0
0,0,0,0,6,0,0,0,0,0,0,6,0,0,0,0
2,0,9,0,6,0,0,0,8,0,0,6,0,0,0,2
0,1,1,1,1,1,1,1,1,1,1,1,1,1,1,0
11,11,11,11,11,11,11,11,11,11,11,11,11,11,11,11
