0,0,0,0,0,0,0,0,0,0,0,0,0,0,0,0
0,0,0,0,0,0,0,0,0,0,0,0,0,0,0,0
1,0,2,0,4,0,8,2,2,0,4,0,0,12,2,1
1,0,0,1,1,1,1,0,0,1,1,7,1,1,0,1
1,0,0,0,0,0,0,0,0,0,0,6,0,0,0,1
1,1,1,1,1,1,7,0,0,1,1,1,0,0,0,1
1,0,0,0,0,0,6,0,0,0,1,0,0,0,0,1
1,0,8,0,0,0,1,1,7,1,1,0,0,1,1,1
1,1,1,2,0,0,4,0,6,0,0,0,0,2,0,1
1,0,0,0,1,1,1,1,1,1,1,7,1,0,0,1
1,0,0,0,0,0,1,0,0,0,0,6,0,0,0,1
1,1,1,1,0,0,1,0,0,0,0,6,0,0,0,1
1,0,0,0,0,0,1,1,7,1,1,1,1,0,0,1
1,0,0,9,0,0,0,0,6,0,0,0,0,0,0,1
1,1,1,1,1,1,1,1,1,1,1,1,1,1,1,1
